11111111111111111111111111111111111111111111111111
11111111111111111111111111111111111111111111111111
11111111111111111111111111111111111111111111111111
11111111111111111111111111111111111111111111111111
11110000000000000000000000000000000000000000011111
11110111111111110111111111011111111101111111011111
11110111111111110111111111011111111101111111011111
11110111111111110111111111011111111101111111011111
11110111111111110111111111011111111101111111011111
11110111100000000000000000000000000000001111011111
11110111101111110111111111011111111101101111011111
11110111101111110111111111011111111101101111011111
11110111101111110111111111011111111101101111011111
11110111101111110111111111011111111101101111011111
11110111101111000000000000000000000101101111011111
11110111101111010111111111011111110101101111011111
11110000000000000000000000011111110101101111011111
11110111101111010111111111011111110101101111011111
11110111101111010111111111011111110101101111011111
11110111101111010110000000000011110101101111011111
11110111101111010110101111011011110101101111011111
11110111101111010110101111000000000000001111011111
11110111101111010110101111011011110101101111011111
11110111101111010110101111011011110101101111011111
11110111101111010110101111011011110101101111011111
11110111101111010110101111011011110101101111011111
11110000000000000000000000000000000000000000011111
11110111101111010110101111011010110101101111011111
11110111101111010110101111011010110101101111011111
11110111101111010110000000000010110101101111011111
11110111101111010111101111111110110101101111011111
11110000000000000000000000000000000000000000011111
11110111101111010111101111111110110101101111011111
11110111101111010111101111111110110101101111011111
11110111101111000000000000000000000101101111011111
11110111101111110111101111111110111101101111011111
11110111101111110111101111111110111101101111011111
11110111101111110111101111111110111101101111011111
11110111101111110111101111111110111101101111011111
11110111100000000000000000000000000000001111011111
11110111111111110111111111111110111101111111011111
11110111111111110111111111111110111101111111011111
11110111111111110111111111111110111101111111011111
11110111111111110111111111111110111101111111011111
11110000000000000000000000000000000000000000011111
11111111111111111111111111111111111111111111111111
11111111111111111111111111111111111111111111111111
11111111111111111111111111111111111111111111111111
11111111111111111111111111111111111111111111111111
11111111111111111111111111111111111111111111111111
