1111111111111111111111111111111111111111
1111111111111111111111111111111111111111
1111111111111111111111111111111111111111
1111111111111111111111111111111111111111
1111000000000000000000000000000000011111
1111010111110111111111110111111011011111
1111010111110111111111110111111011011111
1111010111110111111111110111111011011111
1111010111110111111111110111111011011111
1111010110000000000000000000001011011111
1111010110111111011111111111101011011111
1111010110000000000000000000001011011111
1111010110111111011111111111101011011111
1111010110111111011111111111101011011111
1111010110111100000000000111100011011111
1111010110111101011111110111101011011111
1111010110111101011111110111101011011111
1111010000111101011111110000001011011111
1111010110111101011111110111101011011111
1111010110111101011111110111101011011111
1111010110000001011111110111101011011111
1111010110111101011111110111101011011111
1111010110111101000000000111101011011111
1111010110111101011111110111101011011111
1111010110111100000000000111101011011111
1111010110111111011111111111101011011111
1111000000000000000000000000000000011111
1111010110111111011111111111101111011111
1111010110111111011111111111101111011111
1111010110000000000000000000001111011111
1111010111111111111101111111111111011111
1111010111111111111101111111111111011111
1111010111111111111101111111111111011111
1111010111111111111101111111111111011111
1111000000000000000000000000000000011111
1111111111111111111111111111111111111111
1111111111111111111111111111111111111111
1111111111111111111111111111111111111111
1111111111111111111111111111111111111111
1111111111111111111111111111111111111111
