111111111111111111111111111111111111111111111111111111111111111111111111111111111111
111111111111111111111111111111111111111111111111111111111111111111111111111111111111
111111111111111111111111111111111111111111111111111111111111111111111111111111111111
111111111111111111111111111111111111111111111111111111111111111111111111111111111111
111111111111111111111111111111111111111111111111111111111111111111111111111111111111
111110000000000000000000000000000000000000000000000000000000000000000000000000111111
111110111011111111111111111111111111111111111011111111101111111111101111111110111111
111110111011111111111111111111111111111111111011111111101111111111101111111110111111
111110111011111111111111111111111111111111111011111111101111111111101111111110111111
111110111011111111111111111111111111111111111011111111101111111111101111111110111111
111110111011111111111111111111111111111111111011111111101111111111101111111110111111
111110111010000000000000000000000000000000000000000000000000000000000000111110111111
111110111010111111101111111111111011111111111011111111101111111111101110111110111111
111110111010111111101111111111111011111111111011111111101111111111101110111110111111
111110000000000000000000000000000000000000000000000000000000000000000000000000111111
111110111010111111101111111111111011111111111011111111101111111111101110111110111111
111110111010111111101111111111111011111111111011111111101111111111101110111110111111
111110111010111110000000000000000000000000000000000000000000000000101110111110111111
111110111010111110101111111111111011111111111011111111101111111110101110111110111111
111110111010111110101111111111111011111111111011111111101111111110101110111110111111
111110111010111110101111111111111011111111111011111111101111111110101110111110111111
111110111010111110101111111111111011111111111011111111101111111110101110111110111111
111110111010111110101111111111111011111111111011111111101111111110101110111110111111
111110111010111110101110000000000000000000000000000000000000111110101110111110111111
111110111010111110101110111111111011110111111011111111101110111110000000000000111111
111110111010111110101110111111111011110111111011111111101110111110101110111110111111
111110111010111110101110111111111011110111111011111111101110111110101110111110111111
111110111010111110101110111111111011110111111011111111101110111110101110111110111111
111110111010111110101110111111111011110111111011111111101110111110101110111110111111
111110111010111110101110111110000000000000000000000000101110111110101110111110111111
111110111010111110101110111110111011110111111011111110101110111110101110111110111111
111110111010111110101110111110111011110111111011111110101110111110101110111110111111
111110111010111110101110111110111011110111111011111110101110111110101110111110111111
111110111010111110101110111110111011110111111011111110101110111110101110111110111111
111110111010111110101110111110111011110111111011111110101110111110101110111110111111
111110111010111110101110111110111010000000000000111110101110111110101110111110111111
111110111010111110101110111110111010110111111010111110101110111110101110111110111111
111110111010111110101110111110111010110111111010111110101110111110101110111110111111
111110000000000000000000000000000000000000000000000000000000000000000000000000111111
111110111010111110101110111110111010110111111010110110101110111110101110111110111111
111110111010111110101110111110111010110111111010110110101110111110101110111110111111
111110111010111110101110111110111010110111111010110110101110111110101110111110111111
111110111010111110101110111110111010110111111010110110101110111110101110111110111111
111110111010111110101110111110111010110111111010110110101110111110101110111110111111
111110111010111110101110111110111010110111111010110110101110111110101110111110111111
111110111010111110101110111110000000000000000000000000000000111110101110111110111111
111110111010111110101110111110111010110111111010111110101110111110101110111110111111
111110111010111110101110111110111010000000000000111110101110111110101110111110111111
111110111010111110101110111110111011111111111011111110101110111110101110111110111111
111110111010111110101110111110111011111111111011111110101110111110101110111110111111
111110111010111110101110111110111011111111111011111110101110111110101110111110111111
111110111010111110101110111110111011111111111011111110101110111110101110111110111111
111110111010111110101110111110111011111111111011111110101110111110101110111110111111
111110111010111110101110000000000000000000000000000000101110111110101110111110111111
111110111010111110101110111111111111011111111011111111101110111110101110111110111111
111110111010111110101110111111111111011111111011111111101110111110101110111110111111
111110111010111110101110111111111111011111111011111111101110111110101110111110111111
111110000000000000000000000000000000000000000000000000000000000000000000000000111111
111110111010111110101110111111111111011111111011111111101110111110101110111110111111
111110111010111110101110000000000000000000000000000000000000111110101110111110111111
111110111010111110101111111111111111011111111011111111101111111110101110111110111111
111110111010111110101111111111111111011111111011111111101111111110101110111110111111
111110000000000000000000000000000000000000000000000000000000000000000000000000111111
111110111010111110101111111111111111011111111011111111101111111110101110111110111111
111110111010111110101111111111111111011111111011111111101111111110101110111110111111
111110111010111110000000000000000000000000000000000000000000000000101110111110111111
111110111010111111101111111111111111011111111011111111101111111111101110111110111111
111110111010111111101111111111111111011111111011111111101111111111101110111110111111
111110111010111111101111111111111111011111111011111111101111111111101110111110111111
111110111010111111101111111111111111011111111011111111101111111111101110111110111111
111110111010111111101111111111111111011111111011111111101111111111101110111110111111
111110111010000000000000000000000000000000000000000000000000000000000000111110111111
111110111011111111101111111111111111111111111011111111101111111111101111111110111111
111110111011111111101111111111111111111111111011111111101111111111101111111110111111
111110111011111111101111111111111111111111111011111111101111111111101111111110111111
111110111011111111101111111111111111111111111011111111101111111111101111111110111111
111110111011111111101111111111111111111111111011111111101111111111101111111110111111
111110000000000000000000000000000000000000000000000000000000000000000000000000111111
111111111111111111111111111111111111111111111111111111111111111111111111111111111111
111111111111111111111111111111111111111111111111111111111111111111111111111111111111
111111111111111111111111111111111111111111111111111111111111111111111111111111111111
111111111111111111111111111111111111111111111111111111111111111111111111111111111111
111111111111111111111111111111111111111111111111111111111111111111111111111111111111
111111111111111111111111111111111111111111111111111111111111111111111111111111111111
