1111111111111111111111111111111111111111
1111111111111111111111111111111111111111
1111111111111111111111111111111111111111
1111111111111111111111111111111111111111
1111000000000000000000000000000000011111
1111011111101111101111111111101011011111
1111011111101111101111111111101011011111
1111011111101111101111111111101011011111
1111011111101111101111111111101011011111
1111011110000000000000000000001011011111
1111011110101111101110111111101011011111
1111011110101111101110111111101011011111
1111011110101111101110111111101011011111
1111011110101111101110111111101011011111
1111011110101100000000000111101011011111
1111011110101101111110110111101011011111
1111000000000000000000000000000000011111
1111011110101101111110110111101011011111
1111011110101101111110110111101011011111
1111011110101101111110110111101011011111
1111011110101101111110110111101011011111
1111000000000000000000000000000000011111
1111011110101101111110110111101011011111
1111011110101101111110110111101011011111
1111011110101100000000000111101011011111
1111011110101101111110111111101011011111
1111011110101101111110111111101011011111
1111011110101101111110111111101011011111
1111011110101101111110111111101011011111
1111011110000000000000000000001011011111
1111011111101111111110111111111011011111
1111011111101111111110111111111011011111
1111011111101111111110111111111011011111
1111011111101111111110111111111011011111
1111000000000000000000000000000000011111
1111111111111111111111111111111111111111
1111111111111111111111111111111111111111
1111111111111111111111111111111111111111
1111111111111111111111111111111111111111
1111111111111111111111111111111111111111
