11111111111111111111111111111111111111111111111111
11111111111111111111111111111111111111111111111111
11111111111111111111111111111111111111111111111111
11111111111111111111111111111111111111111111111111
11110000000000000000000000000000000000000000011111
11110111111111111111101111011111111111101111011111
11110111111111111111101111011111111111101111011111
11110111111111111111101111011111111111101111011111
11110111111111111111101111011111111111101111011111
11110111100000000000000000000000000000001111011111
11110111101111111111101111011110111111101111011111
11110111101111111111101111011110111111101111011111
11110111101111111111101111011110111111101111011111
11110111101111111111101111011110111111101111011111
11110111101111000000000000000000000111101111011111
11110111101111011111101111011110110111101111011111
11110000000000011111100000000000000000000000011111
11110111101111011111101111011111110111101011011111
11110111101111011111101111011111110111101011011111
11110111101111011110000000000011110111101011011111
11110111101111011110101111011011110111101011011111
11110111101111011110101111011011110111101011011111
11110111100000000000000000000000000111101011011111
11110111101111011110101111111011110111101011011111
11110111101111011110101111111011110111101011011111
11110111101111011110101111111011110111101011011111
11110111101111011110101111111011110111101011011111
11110111101111011110101111111011110111101011011111
11110111101111011110101111111011110111101011011111
11110111101111011110000000000011110111101011011111
11110111101111011111101111011111110111101011011111
11110000000000000000000000000000000000000000011111
11110111101111011111101111011111110111101111011111
11110111101111011111101111011111110111101111011111
11110111101111000000000000000000000111101111011111
11110111101111111111101111011111111111101111011111
11110111101111111111100000011111111111101111011111
11110111101111111111101111011111111111101111011111
11110111101111111111101111011111111111101111011111
11110111100000000000000000000000000000001111011111
11110111111111111111101111011111111111111111011111
11110111111111111111101111011111111111111111011111
11110111111111111111101111011111111111111111011111
11110111111111111111101111011111111111111111011111
11110000000000000000000000000000000000000000011111
11111111111111111111111111111111111111111111111111
11111111111111111111111111111111111111111111111111
11111111111111111111111111111111111111111111111111
11111111111111111111111111111111111111111111111111
11111111111111111111111111111111111111111111111111
